###############
#!           !#
#  #    ##### #
#  #    #    ##
#  #    #     #
#  #  @ #     #
#  ######     #
#             #
###########   #
#         #   #
#  #      #   #
#  ########   #
#!           !#
###############

###############
#!...........!#
#.............#
#.............#
#.............#
#.............#
#.............#
#.............#
#.............#
#.............#
#.............#
#.............#
#!...........!#
###############

#############################
#!.........................!#
#...##...##.......##...##...#
#...#.....#.......#.....#...#
#......@....................#
#...#.....#.......#.....#...#
#...##...##.......##...##...#
#...##...##.......##...##...#
#...#.....#.......#.....#...#
#...........................#
#...#.....#.......#.....#...#
#...##...##.......##...##...#
#...##...##.......##...##...#
#...#.....#.......#.....#...#
#...........................#
#...#.....#.......#.....#...#
#...##...##.......##...##...#
#...##...##.......##...##...#
#...#.....#.......#.....#...#
#...........................#
#...#.....#.......#.....#...#
#...##...##.......##...##...#
#!.........................!#
#############################